%%%%%%%%%%%%%
%...........%
%.         .%
%%         .%
%.         %%
%.         .%
%P....%.....%
%%%%%%%%%%%%%
